32
48
20 	23 	23 	0 	23 	23 	23 	20 	23 	23 	23 	23 	23 	23 	23 	20 	20 	23 	23 	23 	23 	23 	23 	20 	23 	23 	23 	23 	23 	23 	23 	20
22 	30 	0 	0 	0 	0 	0 	20 	0 	0 	0 	0 	0 	0 	0 	24 	22 	0 	0 	0 	0 	0 	0 	20 	0 	0 	0 	0 	0 	0 	0 	24
22 	0 	0 	0 	0 	0 	0 	20 	0 	32	29	0	0	0	0	24	22	0	0	0	0	0	0	20	0	0	0	0	0	0	0	24
22	0	0	0	0	0	0	0	0	31	30  0   0   0   0   0   0   0   0   0   0   0   0   20  0   0   0   0   0   0   0   24
22	0	0	0	0	0	0	20	0	0	0	0	0	0	0	0	0	0	0	0	0	0	0	20	0	0	0	0	0	0	0	24
26	0	0	0	0	0	0	20	0	0	0	0	0	0	0	24	22	0	0	0	0	0	0	20	0	0	0	0	0	0	0	24
22	0	0	0	0	0	0	20	0	0	0	0	0	0	0	24	22	0	0	0	0	0	0	20	0	0	0	0	0	0	0	24
22	0	0	0	0	0	0	20	0	0	0	0	0	0	0	24	22	0	0	0	0	0	0	20	0	0	0	0	0	0	0	24
22	0	0	0	0	0	0	0	0	0	0	0	0	0	0	24	22	0	0	0	0	0	0	0	0	0	0	0	0	0	0	24
22	0	0	0	0	0	0	0	0	0	0	0	0	0	0	24	22	0	0	0	0	0	0	0	0	0	0	0	0	0	0	24
22	0	0	0	0	0	0	0	0	0	0	0	0	0	0	24	22	0	0	0	0	0	0	0	0	0	0	0	0	0	0	24
20	21	21	21	21	0	0	21	21	21	21	21	21	21	21	20	20	21	21	21	21	0	0	21	21	21	21	2	2	21	21	20
20	23	23	23	23	0	0	23	23	23	23	23	23	23	23	20	20	23	23	23	23	0	0	23	23	23	23	23	23	23	23	20
22	0	20	0	0	0	0	0	0	0	0	0	0	0	0	24	22	0	0	0	0	0	0	0	0	0	0	0	0	0	0	24
22	0	0	0	0	0	0	0	0	0	32	29	0	0	0	24	22	0	0	0	0	0	0	0	0	0	0	0	0	0	0	24
22	0	0	0	0	0	0	0	0	0	31	30	0	0	0	24	22	0	0	0	0	0	0	0	0	0	0	0	0	0	0	24
22	0	0	0	0	0	0	0	0	0	0	0	0	0	0	24	22	0	0	0	0	0	0	0	0	0	0	0	0	0	0	24
22	0	0	0	0	0	0	0	0	0	0	0	0	0	0	24	22	0	0	0	0	0	0	0	0	0	0	0	0	0	0	24
22	0	0	0	0	0	0	0	0	0	0	0	0	0	0	24	22	0	0	0	0	0	0	0	0	0	0	0	0	0	0	24
22	0	0	0	0	0	0	20	0	0	0	0	0	0	0	24	22	0	0	0	0	0	0	20	0	0	0	0	0	0	0	24
22	0	0	0	0	0	0	20	0	0	0	0	0	0	0	24	22	0	0	0	0	0	0	20	0	0	0	0	0	0	0	24
22	0	0	0	0	0	0	0	0	0	0	0	0	0	0	0	0	0	0	0	0	0	0	0	0	0	0	0	0	0	0	24
22	0	0	0	0	0	0	0	0	0	0	0	0	0	0	0	0	0	0	0	0	0	0	0	0	0	0	0	0	0	0	24
20	21	21	21	21	0	0	21	21	21	21	21	21	21	21	21  21	21	21	21	21	21	0	0	21	21	21	21	21	21	21	20
20	23	23	23	23	0	0	23	23	23	23	23	23	23	23	20  20	24	23	23	23	23	0	0	23	23	23	23	23	23	23	20
22	0	0	20	0	0	0	0	0	0	0	0	0	0	0	24	22	0	0	0	0	0	0	0	0	0	0	0	0	0	0	24
22	0	0	0	0	0	0	0	0	0	0	0	0	0	0	24	22	0	0	0	0	0	0	0	0	0	0	0	0	0	0	24
22	0	0	0	0	0	0	0	0	0	0	0	0	0	0	24	22	0	0	0	0	0	0	0	0	0	0	0	0	0	0	24
22	0	0	0	0	0	0	0	0	0	0	0	0	0	0	24	22	0	0	0	0	0	0	0	0	0	0	0	0	0	0	24
22	0	0	0	0	0	0	0	0	0	0	0	0	0	0	24	22	0	0	0	0	0	0	0	0	0	0	0	0	0	0	24
22	0	0	0	0	0	0	0	0	0	0	0	0	0	0	24	22	0	0	0	0	0	0	0	0	0	0	0	0	0	0	24
22	0	0	0	0	0	0	20	0	0	0	0	0	0	0	24	22	0	0	0	0	0	0	20	0	0	0	0	0	0	0	24
22	0	0	0	0	0	0	20	0	0	0	0	0	0	0	24	22	0	0	0	0	0	0	20	0	0	0	0	0	0	0	24
22	0	0	0	0	0	0	0	0	0	0	0	0	0	0	24	22	0	0	0	0	0	0	0	0	0	0	0	0	0	0	24
22	0	0	0	0	0	0	0	0	0	0	0	0	0	0	24	22	0	0	0	0	0	0	0	0	0	0	0	0	0	0   24
20	21	21	21	21	0	0	21	21	21	21	21	21	21	21	20	20	21	21	21	0	0	21	21	21	21	21	21	21	21	21  20
20	23	23	23	23	0	0	23	23	23	23	23	23	23	23	20	20	23	23	23	0	0	23	23	23	23	23	23	23	23	23  20
22	0	0	0	20	0	0	0	0	0	0	0	0	0	0	24	22	0	0	0	0	0	0	0	0	0	0	0	0	0	0	24
22	0	0	0	0	0	0	0	0	0	0	0	0	0	0	24	22	0	0	0	0	0	0	0	0	0	0	0	0	0	0	24
22	0	0	0	0	0	0	0	0	0	0	0	0	0	0	24	22	0	0	0	0	0	0	0	0	0	0	0	0	0	0	24
22	0	0	0	0	0	0	0	0	0	0	0	0	0	0	24	22	0	0	0	0	0	0	0	0	0	0	0	0	0	0	24
22	0	0	0	0	0	0	0	0	0	0	0	0	0	0	24	22	0	0	0	0	0	0	0	0	0	0	0	0	0	0	24
22	0	0	0	0	0	0	0	0	0	0	0	0	0	0	24	22	0	0	0	0	0	0	0	0	0	0	0	0	0	0	24
22	0	0	0	0	0	0	20	0	0	0	0	0	0	0	24	22	0	0	0	0	0	0	20	0	0	0	0	0	0	0	24
22	0	0	0	0	0	0	20	0	0	0	0	0	0	0	24	22	0	0	0	0	0	0	20	0	0	0	0	0	0	0	24
22	0	0	0	0	0	0	0	0	0	0	0	0	0	0	24	22	0	0	0	0	0	0	0	0	0	0	0	0	0	0	24
22	0	0	0	0	0	0	0	0	0	0	0	0	0	0	0	0	0	0	0	0	0	0	0	0	0	0	0	0	0	0   24
20	21	21	21	21	21	21	21	21	21	21	21	21	21	21	21	21	21	21	21	21	21	21	21	21	21	21	21	21	21	21	20
